####...#######...#######...####
#.........#.........#.........#
#.........#.........#.........#
...............................
.....#.#.......#.#.......#.#...
...............................
#....#....#....#....#....#....#
#.........#.........#.........#
#.........#.........#.........#
#.........#.........#.........#
####...#######...#######...####
#.........#.........#.........#
#.........#.........#.........#
...............................
.....#.#.......#.#.......#.#...
..................@............
#....#....#....#....#....#....#
#.........#.........#.........#
#.........#.........#.........#
#.........#.........#.........#
####...#######...#######...####
#.........#.........#.........#
#.........#.........#.........#
...............................
.....#.#.......#.#.......#.#...
...............................
#....#....#....#....#....#....#
#.........#.........#.........#
#.........#.........#.........#
#.........#.........#.........#
####...#######...#######...####